Level1
2222112222222222200000000
1111111111111111100000000
1111111111111111100000000
1111111111111111100000000
1111111111111111100000000
1111111111111111100000000
1111111111111111100000000
1111111111111111111111100
1111111111111111111111100
1111111111111111111111100
1111111111111111111111100
1111111111111111111111100
1111111111111111100000000
1111111111111111100000000
2222222211222222200000000
2222222211222222200000000
1111111111111111100000000
1111111111111111100000000
1111111111111111100000000
1111111111111111100000000
Level2
2222112222222222200000000
1111111111111111100000000
1111111111111111100000000
1111111111111111100000000
1111111111111111100000000
1111111111111111100000000
1111111111111111100000000
1111111111111111111111100
1111111111111111111111100
1111111111111111111111100
1111111111111111111111100
1111111111111111111111100
1111111111111111100000000
1111111111111111100000000
2222221111222222200000000
2222221111222222200000000
2222221111211111200000000
2222221111211111200000000
2222221111211111200000000
2222221111222222200000000
